1111111110000001111111111111
1000000011111111000000001000
1000000000000000000000001111
1000000000000000000000001001
1111100011111110001111111001
1000100000000000000000001001
1000100000000000000000001001
1000100000000000000000001001
1000100000000000000000001001
10001000000S0000000011111011
1000000000000000000000001001
1111100000001111111110001001
1000000000000000000000000001
1000000000000000000000001001
1000000000000000000011111001
1000100000000000000000000001
1000100000000000000000000001
1000100000000111111100000001
1000100000000100000100000001
1000100000000100000100000001
1000100000000100000100000001
1000100000000100000000000001
1111111110001110001111111101
1000001000000000000000100001
1110001000000000000000100001
0010001000000000000000111111
0010000000000000000000100000
0011111111111111111111100000
