1111111111111111111111111111
1000000000000000000000001001
1000000000000000000000001001
1000000000000000000000001001
1111100010001010001111111001
1000100000000000000000001001
100010000000N000000000001001
1000000000000000000000001001
1111100010001110001010001001
1000000000000000000000000001
1000000000000000000000001001
1000000000000000000011111001
1000100000000000000000000001
1000100000000000000000000001
1000100000000000000000000001
1111111110001010001111111101
1000001000000000000000100001
1000001000000000000000100001
1000001000000000000000100001
1000000000000000000000100001
1111111111111111111111111111
