11111111111
10000000001
1000E000111
100000001
11111111111